000000000000000000000000000000112222221122222221100002211200
000000000000000000000000000000112222221122222221100002211200
000000000000000000000000000000112222221122222221100002211200
000000020002000000000000000000000000020002000000000000000000
000000012221000002220002002000000000012221000002220002002000
000000000000000000000000000000000000000000000000000000000000
220000002200000002200000022000220000002200000002200000022000
112222221122222221100002211200112222221122222221100002211200
111111111111111111100001111100111111111111111111100001111100
111111111111111111100000110000111111111111111111100000110000
111111111111111111100000100000111111111111111111100000100000
111111111111111111100000100000111111111111111111100000100000
111111111111111111100000000000111111111111111111100000000000